1:./src/Images/mur.png:true:Mur
5:./src/Images/chemin.png:false:Chemin
0:./src/Images/boule_simple.png:false:Boule_simple
4:./src/Images/porte_enclos.png:true:Porte_enclos
3:./src/Images/boule_speciale.png:false:Boule_speciale
2:spawn

1 1 1 1 1 1 1 1 1 1 1 1 1 1 1 1 1 1 1 1 1 1 1 1 1 1 1 1
1 0 0 0 0 0 0 0 0 0 0 0 0 1 1 0 0 0 0 0 0 0 0 0 0 0 0 1
1 0 1 1 1 1 0 1 1 1 1 1 0 1 1 0 1 1 1 1 1 0 1 1 1 1 0 1
1 3 1 1 1 1 0 1 1 1 1 1 0 1 1 0 1 1 1 1 1 0 1 1 1 1 3 1
1 0 1 1 1 1 0 1 1 1 1 1 0 1 1 0 1 1 1 1 1 0 1 1 1 1 0 1
1 0 0 0 0 0 0 0 0 0 0 0 0 0 0 0 0 0 0 0 0 0 0 0 0 0 0 1
1 0 1 1 1 1 0 1 1 0 1 1 1 1 1 1 1 1 0 1 1 0 1 1 1 1 0 1
1 0 1 1 1 1 0 1 1 0 1 1 1 1 1 1 1 1 0 1 1 0 1 1 1 1 0 1
1 0 0 0 0 0 0 1 1 0 0 0 0 1 1 0 0 0 0 1 1 0 0 0 0 0 0 1
1 1 1 1 1 1 0 1 1 1 1 1 5 1 1 5 1 1 1 1 1 0 1 1 1 1 1 1
5 5 5 5 5 1 0 1 1 1 1 1 5 1 1 5 1 1 1 1 1 0 1 5 5 5 5 5
5 5 5 5 5 1 0 1 1 5 5 5 5 5 5 5 5 5 5 1 1 0 1 5 5 5 5 5
5 5 5 5 5 1 0 1 1 5 1 1 1 4 4 1 1 1 5 1 1 0 1 5 5 5 5 5
1 1 1 1 1 1 0 1 1 5 1 5 5 5 5 5 5 1 5 1 1 0 1 1 1 1 1 1
5 5 5 5 5 5 0 5 5 5 1 5 5 5 5 5 5 1 5 5 5 0 5 5 5 5 5 5
1 1 1 1 1 1 0 1 1 5 1 5 5 5 5 5 5 1 5 1 1 0 1 1 1 1 1 1
5 5 5 5 5 1 0 1 1 5 1 1 1 1 1 1 1 1 5 1 1 0 1 5 5 5 5 5
5 5 5 5 5 1 0 1 1 5 5 5 5 5 5 5 5 5 5 1 1 0 1 5 5 5 5 5
5 5 5 5 5 1 0 1 1 5 1 1 1 1 1 1 1 1 5 1 1 0 1 5 5 5 5 5
1 1 1 1 1 1 0 1 1 5 1 1 1 1 1 1 1 1 5 1 1 0 1 1 1 1 1 1
1 0 0 0 0 0 0 0 0 0 0 0 0 1 1 0 0 0 0 0 0 0 0 0 0 0 0 1
1 0 1 1 1 1 0 1 1 1 1 1 0 1 1 0 1 1 1 1 1 0 1 1 1 1 0 1
1 0 1 1 1 1 0 1 1 1 1 1 0 1 1 0 1 1 1 1 1 0 1 1 1 1 0 1
1 3 0 0 1 1 0 0 0 0 0 0 0 0 2 0 0 0 0 0 0 0 1 1 0 0 3 1
1 1 1 0 1 1 0 1 1 0 1 1 1 1 1 1 1 1 0 1 1 0 1 1 0 1 1 1
1 1 1 0 1 1 0 1 1 0 1 1 1 1 1 1 1 1 0 1 1 0 1 1 0 1 1 1
1 0 0 0 0 0 0 1 1 0 0 0 0 1 1 0 0 0 0 1 1 0 0 0 0 0 0 1
1 0 1 1 1 1 1 1 1 1 1 1 0 1 1 0 1 1 1 1 1 1 1 1 1 1 0 1
1 0 1 1 1 1 1 1 1 1 1 1 0 1 1 0 1 1 1 1 1 1 1 1 1 1 0 1
1 0 0 0 0 0 0 0 0 0 0 0 0 0 0 0 0 0 0 0 0 0 0 0 0 0 0 1
1 1 1 1 1 1 1 1 1 1 1 1 1 1 1 1 1 1 1 1 1 1 1 1 1 1 1 1